1111111111111111111
10000011101000E0001
1111110000000PC0001
1111111111111111111