1111111111111111111
1000001110100000001
1000001110100000001
1000001110100000001
1000001110100000001
1000001110100000001
1000001110100000001
1000001110100000001
1000001110100000001
1000001110100000001
1000001110100000001
1000001110100000001
1000001110100000001
1000001110100000001
1000001110100000001
1000001110100000001
1000001110100000001
1000001110100000001
1000001110000000001
1000001110000000001
1000001110000000001
10000011100000E0001
111111000P0000C0001
1111111111111111111