1111111111111111111
1000001110100000001
1000001110100000001
1000001110100000001
1000001110100000001
1000001110100000001
1000001110100000001
1000001110100000001
1000001110100000001
1000001110100000001
1000001110100000001
1000001110100000001
1000001110100000001
1000001110100000001
1000001110100P00001
1000001110100000001
1000001110100000001
1000001110100C00001
1000001110000000001
1000001110000000001
1000001110000000001
10000011100000E0001
1111110000000000001
1111111111111111111