1111111111111111111
10000011101000E0001
11111100000000C0001
10C00000100P0010001
1C11000010000000001
1111111110111111111
1000000000000C00011
1000000000000C00011
1000000000000C00011
1000000000000C00011
1000000000000C00011
1000000000000C00011
1000000000000C00011
1111111111111111111