11111111111
10000000001
10000000001
10000ECP0011
11111111111