11111111111
10000000001
10000000001
10000EP0001
11111111111