11111111111
10000000001
10000000001
100000CP001
11111111111