1111111111111111111
10000011101C0000001
1000001110100C00001
10000011101000E0C01
10000011101P0000001
1111111111111111111