1111111111111111111
100000111P100000001
100000111C100000001
100000111C100000001
100000111E100000001
1111111111111111111