1111111111111111111
1000001110100000001
10000011101000PCCC1
10000011101000CCCC1
10000011101000E0001
1111111111111111111