1111111111111111111111
1000000000000000000001
100000000C000000000001
1000000000011111000001
100000C000010000000001
10000000000100E0000001
1000000001110000000001
1000000000001111000001
100P000000000000000001
100000000C000000000001
1111111111111111111111